############################
#   8      #  8#    9#   # #
#  ##  ##   #  8#  8#   #  #
##    #  #  # 988    #  #  #
##    #  #  #  #    ##   # #
##   9 # #  #     #        #
# 9#    9###     #  #    # #
#   # #  #    # 88   # 9 ###
#  #8     8#     #  ##     #
#   98# 8# # #       #  #  #
# 8#  # 9 #8     #  #    # #
#   # # #    # # #  #  #8 ##
#  #  #9###    #    #  98 ##
# 8  ##  8#    8 #     #   #
#########################D##
